MMMMMMMMMMMMMMMMMMMMMMMMMMMMMMMM
MDRVVVTTTDMTTTRRTTTTTTTMDMTRTTTM
MTMMDTMTMMTTTTTDTTTTTTMVVVVTTTTM
MTTMMMMMMMTTTMMMMTTTTTTMMMMMTTTM
MRTTTTTPMTTTTTTTTTRMTTTTTTTTTTTM
MMTTTTTTTTTTTTTTTTTTDTTTTTTTTTTM
MMTTTTTTTTTTTTTTTTVMTTTTTTTTTTTM
MTTMMMMMMTTMMMMMTTVMTTTTTTTTTTTM
MTTTTTTTTTTTTTTTTTVMMMMMMMMMMTTM
MTTTTTTTTTTTTTTTTTVMTTTRRRRRRTTM
MVTTTMMMMMMMTTTTTTVMTTTTTTTTTTTM
MTTTTMMMMMMDMTTTTTVMTTTVVVVVVTTM
MTRRTRVVVVVVVMVVMTVMTTTDVVVVVTTM
MMTTMMMMRRRRRRMTTTVMMMMMMMMMMMMM
MTTTTTTDTTTTTTTTTTVTTTTTDTTTTTTM
MMMMMMMMMMMMMMMMMMMMMMMMMMMMMMMM