MMMMMMMMMMMMMMMMMMMMMMMMMMMMMMMM
MRMMMTVMRMTVMRMTVMRMTVMRMTVMTTTM
MMTVRRMTMMRMTTMRMTMMRMTMMRMTVMTM
MVVVMMMTVMMMTTMRMTMMRMTMMRMTVMTM
MTTTVRTVMVMTVMRMTVMRMTVMRMTVMTMM
MDVVPTVTVVVMTVMRMTVMRMTVMRMTVMTM
MMTVMVMTVVVMTVVRMTVMRMTVMRMTVMTM
MMTVMVMTTDRVVVVTVTVTRMTRRRMTVMTM
MMTVMVMTTMRMMMTRMTVTTTTTTRMTVMTM
MMTTMVMTTMRMMVTRMTVMVMTVMRMTVMTM
MMTVMRMTDMRMMVTRMTVMRMTVMRMTVMTM
MMTVMRMTVMRMMVTRMTVMRRTVMRMTVMTM
MMTVMRMTVMRMTVMRMMMMMMTVMRMTVMTM
MMTVMRMTVMRMTVMRMTVTRTTVMRMTVMTM
MMTVMRMTVMRMTVMRMTVTRTTVTTTTTTDM
MMMMMMMMMMMMMMMMMMMMMMMMMMMMMMMM