MMMMMMMMMMMMMMMMMMMMMMMMMMMMMMMM
MMMMTRMTVMRMTVMRMTVMRMTVMRMTVMTM
MMMMRMMTVMRMTVMRMTVMRMTVMRMTVMTM
MMMMTTTTVMMMTVMRMTVMRMTVMRMTVMTM
MTTTVRTVMVMTVMRMTVMRMDVMRMTVMTMM
MDVVPTVTTTTTTVTRVVVDRMTVMRMTVMTM
MMTVMVMTTTTTTVTRVVVTRTTVMRMTVMTM
MMTVMVMTVDRVTVVRVTVTRMTVMRMTVMTM
MMTVMVMTVMRMTVMRMTTMRMTVMRMTVMTM
MMTTMVMTVMRMTVMRMTTMRMTVMRMTVMTM
MMTVMRMTVMRMTVMRMTTMRMTVMRMTVMTM
MMTVMRMTVMRMTVMRMTTMRMTVMRMTVMTM
MMTVMRMTVMRMTVMRMTVMRMTVMRMTVMTM
MMTVMRMTVMRMTVMRMTVTTTTVMRMTVMTM
MMTVMRMTVMRMTVMRMTVMRMTVMRMTVMTM
MMMMMMMMMMMMMMMMMMMMMMMMMMMMMMMM